########################################################################################################################
#S     #E                     # e    e      ############                                                    ############
#                                           ############                                                    ############
#####  #          ##########                ############            E                       R               ############
#      #          #############             ############       R        ##############                      ############
#E     ######E    #############             ############                ##############                      ############
#      #          #############    e    e             ##                ##############                      ############
#     E#          ###########################         ##R               ##############           R          ############
#      #     ##################                       ##                ##############                      ############
#  #####     ##################                       ##                ##############                      ############
#  #####     ##################                       ##       e        ############################        ############
#            ##################           R           ##           R                         #######  E     ############
#         e  ##################                       ##                                     #######        ############
###############################      ###################                                     #######     e  ############
#                         #####      ###################                                     #######        ############
#                         #####      #######################################                 #######        ############
#                         #####              e                                               #######        ############
#                         #####                  e                    R                      #######        ############
#                         #####                      e                        R              #######                   #
#                                               ##################                 R         #######         R         #
####################                            ##################      R                    #######                   #
####################                            ##################                           #######     R             #
####################                            ##################        R                  #######                   #
####################    R                       ##################                           #######                  G#
########################################################################################################################